11111111111111111111111111111
17000000000000070000040000005
10000000040000070000000000001
10040000011111111110000000001
10006660000266666660007000001
10006160000000000010000000001
10006160000000004010000400001
10006660400000000010000000001
10000000000000000010000007001
10000001111110000010000000001
10004006666660000000000040001
10000000000000000000000000001
10007100000000000040000000001
10007100000000000000000000001
10007100004000000011111100001
10007100000000000066666640001
14007100000000000000000000001
10007100000000011110000000001
50000600000000066660000000001
11111111111111111111111111111
