##############X##############
#8000000000000I000000000000IX
#000000000000008000000000000#
#00400000##########000000000#
#0007770000P7777777000800000#
#0007#700000000000#000000000#
#0007#700000000000#000030000#
#00077700000000000#000000000#
#00000000000000000#000000800#
#000000######00000#000000000#
#000000777777000000000000000#
#000000000000000000000000000#
#0008#0000000000000000000000#
#0008#0000000000000000000000#
#0008#000040000000######0000#
#0008#0000000000007877770000#
#4008#0000000077778700000000#
#0008#000000007####700000000#
XI0007778777777777770I000000#
#####################X#######
