111111111111611111111111
180000000000070000000006
100000000000080000000001
100400001111111114000001
100077700277777770008001
140081000000777787000401
100081000000711117000001
600007777777777777000001
111111111111111111161111
